Raamatud

Draama:
Kuidas elad, Ann? - Aidi Vallik
Klass - Gerda Kordemets
Nullpunkt - Margus Karu
Kurat ja ingel mu õlal - Maarja Astover
Topelt D - Kristi Piiper
Jagatud saladused - Agnes Kolga

Fantaasia:
Rehepapp - Andrus Kivirähk
Rahel, Anders ja ajaaugud - Reeli Reinaus
Kummituste peatänav - Jana Maasik
Uks - Ilmar Tomusk
Kaarnapuu - Grethe Rõõm
Saskia läheb metsa - Häli Kivisild
Me kasvasime maal - Thor Peterson
Viimane hingelind - Berit Sootak
Roosi märgi all - Reeli Reinaus
Keegi teine - Liina Vagula

Krimi:
King nr 39 - Jaanus Vaiksoo
Ta ei teinud seda - Ketlin Priilinn
Mõõkade äss - Reeli Reinaus
Valge nagu lumi - Salla Simukka
Hull hobune - Katrin Pauts
Apteeker Melchior ja Oleviste mõistatus - Indrek Hargla

Õudus:
Verikambi - Reeli Reinaus
Vihmakass - Mart Kuhi
Süvahavva: esimene suvi - Indrek Hargla
Kadunud Hõim - Mehis Heinsaar

Põnevik:
Viivuranna online - Maniakkide tänav
Mõistatus lossivaremetes - Reeli Reinaus
Ekraani taga - Carolin Kuuskmäe
Domineeriv värv: Tumepunane - Koidu V. G. Ferreira

Romantika:
Kui armastus külmutab südame: väljavalitu - Koidu V. G. Ferreira
Nähtamatu tüdruk - Kaia Raudsepp
Tinderikooma - Kristi Piiper
Lõpupidu - Heli Künnapas
Mälestusteta suvi - Heli Künnapas
Ütlemata sõnad - Heli Künnapas
Varjajad - Agnes Kolga
Valu tühi veetlus - Mai Raet